5
5
1
0,0,0,0,0
0,G,1,0,0
0,0,1,1,1
0,0,0,0,P
0,0,0,0,0