5
5
1
0,0,0,0,0
0,0,1,G,0
0,1,1,0,0
0,P,0,0,0
0,0,0,0,0