Forest
5
5
2
1,2,1,2,1
2,1,2,1,2
1,2,1,2,1
2,1,2,1,2
1,2,1,2,1
R,R,R,R,0
R,G,0,F,0
R,R,0,F,0
0,R,0,F,0
0,R,P,F,0