Forest
5
5
2
1,2,1,2,1
2,1,2,1,2
1,2,1,2,1
2,1,2,1,2
1,2,1,2,1
0,R,R,R,R
0,F,0,G,R
0,F,0,R,R
0,F,0,R,0
0,F,P,R,0