Forest
6
6
2
1,2,1,2,1,2
2,1,2,1,2,1
1,2,1,2,1,2
2,1,2,1,2,1
1,2,1,2,1,2
2,1,2,1,2,1
0,0,0,0,0,0
0,R,R,R,R,0
0,R,T,T,R,0
0,R,W,W,R,0
0,R,W,W,R,0
P,R,T,T,R,G