Forest
5
5
2
1,2,1,2,1
2,1,2,1,2
1,2,1,2,1
2,1,2,1,2
1,2,1,2,1
R,R,T,T,F
R,T,0,G,F
R,0,0,T,F
R,P,R,R,F
T,T,T,R,F