Forest
5
5
2
1,2,1,2,1
2,1,2,1,2
1,2,1,2,1
2,1,2,1,2
1,2,1,2,1
T,T,T,T,T
R,G,0,R,R
R,R,0,0,0
0,R,R,R,P
T,T,T,T,T